




                              ━━━━━━━━━━━━━━━━━━━━━━━━━━━━━━━━━━━━━━━
                              ━━━━━━━━ ┏━━━┓┏━━━┓┏━┓┏━┓┏━━━┓ ━━━━━━━━
                              ━━━━━━━━ ┃┏━┓┃┃┏━┓┃┃ ┗┛ ┃┃┏━━┛ ━━━━━━━━
                              ━━━━━━━━ ┃┃ ┗┛┃┃ ┃┃┃┏┓┏┓┃┃┗━━┓ ━━━━━━━━
                              ━━━━━━━━ ┃┃┏━┓┃┗━┛┃┃┃┃┃┃┃┃┏━━┛ ━━━━━━━━
                              ━━━━━━━━ ┃┗┻━┃┃┏━┓┃┃┃┃┃┃┃┃┗━━┓ ━━━━━━━━
                              ━━━━━━━━ ┗━━━┛┗┛ ┗┛┗┛┗┛┗┛┗━━━┛ ━━━━━━━━
                              ━━━━━━━━━━━━━━━━━━━━━━━━━━━━━━━━━━━━━━━
                              ━━━━━━━━ ┏━━━┓┏┓  ┏┓┏━━━┓┏━━━┓ ━━━━━━━━
                              ━━━━━━━━ ┃┏━┓┃┃┗┓┏┛┃┃┏━━┛┃┏━┓┃ ━━━━━━━━
                              ━━━━━━━━ ┃┃ ┃┃┗┓┃┃┏┛┃┗━━┓┃┗━┛┃ ━━━━━━━━
                              ━━━━━━━━ ┃┃ ┃┃ ┃┗┛┃ ┃┏━━┛┃┏┓┏┛ ━━━━━━━━
                              ━━━━━━━━ ┃┗━┛┃ ┗┓┏┛ ┃┗━━┓┃┃┃┗┓ ━━━━━━━━
                              ━━━━━━━━ ┗━━━┛  ┗┛  ┗━━━┛┗┛┗━┛ ━━━━━━━━
                              ━━━━━━━━━━━━━━━━━━━━━━━━━━━━━━━━━━━━━━━
                              ━━━━━━━━━━━━━━━  _____  ━━━━━━━━━━━━━━━ 
                              ━━━━━━━━━━━━━━  /     \  ━━━━━━━━━━━━━━
                              ━━━━━━━━━━━━━  | X   X |  ━━━━━━━━━━━━━
                              ━━━━━━━━━━━━━━  \  ^  /  ━━━━━━━━━━━━━━
                              ━━━━━━━━━━━━━━━  |||||  ━━━━━━━━━━━━━━━
                              ━━━━━━━━━━━━━━━  |||||  ━━━━━━━━━━━━━━━
                              ━━━━━━━━━━━━━━━━━━━━━━━━━━━━━━━━━━━━━━━
