




                                  ━━━━━━━━━━━━━━━━━━━━━━━━━━━━━━━━━━━━━━━━━━━━━━━━━━━━━━━━━━━━━━━━━━━━━━━━━━━━━━
                                 |                  ━━━━━━━━━━━━━━━━━━━━━━━━━━━━━━━━━━━━━━━                     |
                                 |                  ━━━━━━━━ ┏━━━┓┏━━━┓┏━┓┏━┓┏━━━┓ ━━━━━━━━                     |
                                 |                  ━━━━━━━━ ┃┏━┓┃┃┏━┓┃┃ ┗┛ ┃┃┏━━┛ ━━━━━━━━                     |
                                 |                  ━━━━━━━━ ┃┃ ┗┛┃┃ ┃┃┃┏┓┏┓┃┃┗━━┓ ━━━━━━━━                     |
                                 |                  ━━━━━━━━ ┃┃┏━┓┃┗━┛┃┃┃┃┃┃┃┃┏━━┛ ━━━━━━━━                     |
                                 |                  ━━━━━━━━ ┃┗┻━┃┃┏━┓┃┃┃┃┃┃┃┃┗━━┓ ━━━━━━━━                     |
                                 |                  ━━━━━━━━ ┗━━━┛┗┛ ┗┛┗┛┗┛┗┛┗━━━┛ ━━━━━━━━                     |
                                 |                  ━━━━━━━━━━━━━━━━━━━━━━━━━━━━━━━━━━━━━━━                     |
                                 |                  ━━━━━━━━ ┏━━━┓┏┓  ┏┓┏━━━┓┏━━━┓ ━━━━━━━━                     |
                                 |                  ━━━━━━━━ ┃┏━┓┃┃┗┓┏┛┃┃┏━━┛┃┏━┓┃ ━━━━━━━━                     |
                                 |                  ━━━━━━━━ ┃┃ ┃┃┗┓┃┃┏┛┃┗━━┓┃┗━┛┃ ━━━━━━━━                     |
                                 |                  ━━━━━━━━ ┃┃ ┃┃ ┃┗┛┃ ┃┏━━┛┃┏┓┏┛ ━━━━━━━━                     |
                                 |                  ━━━━━━━━ ┃┗━┛┃ ┗┓┏┛ ┃┗━━┓┃┃┃┗┓ ━━━━━━━━                     |
                                 |                  ━━━━━━━━ ┗━━━┛  ┗┛  ┗━━━┛┗┛┗━┛ ━━━━━━━━                     |
                                 |                  ━━━━━━━━━━━━━━━━━━━━━━━━━━━━━━━━━━━━━━━                     |
                                 |                  ━━━━━━━━━━━━━━━  _____  ━━━━━━━━━━━━━━━                     |
                                 |                  ━━━━━━━━━━━━━━  /     \  ━━━━━━━━━━━━━━                     |
                                 |                  ━━━━━━━━━━━━━  | X   X |  ━━━━━━━━━━━━━                     |
                                 |                  ━━━━━━━━━━━━━━  \  ^  /  ━━━━━━━━━━━━━━                     |
                                 |                  ━━━━━━━━━━━━━━━  |||||  ━━━━━━━━━━━━━━━                     |
                                 |                  ━━━━━━━━━━━━━━━  |||||  ━━━━━━━━━━━━━━━                     |
                                 |                  ━━━━━━━━━━━━━━━━━━━━━━━━━━━━━━━━━━━━━━━                     |
                                 ━━━━━━━━━━━━━━━━━━━━━━━━━━━━━━━━━━━━━━━━━━━━━━━━━━━━━━━━━━━━━━━━━━━━━━━━━━━━━━
