 _______________________________________________________________________________
|                               - DECODER -                                     |
| Atbash:                                                                       |
|                                                                               |
| A:    B:    C:    D:    E:    F:    G:    H:    I:    J:    K:    L:    M:    |
| Z     Y     X     W     V     U     T     S     R     Q     P     O     N     |
|                                                                               |
| N:    O:    P:    Q:    R:    S:    T:    U:    V:    W:    X:    Y:    Z:    |
| M     L     K     J     I     H     G     F     E     D     C     B     A     |
|-------------------------------------------------------------------------------|
| ASCII:                                                                        |
|                                                                               |
| A:    B:    C:    D:    E:    F:    G:    H:    I:    J:    K:    L:    M:    |
| 65    66    67    68    69    70    71    72    73    74    75    76    77    |
|                                                                               |
| N:    O:    P:    Q:    R:    S:    T:    U:    V:    W:    X:    Y:    Z:    |
| 78    79    80    81    82    83    84    85    86    87    88    89    90    |
|-------------------------------------------------------------------------------|
| Binary:                                                                       |
|                                                                               |
| A:         B:         C:         D:         E:         F:         G:          |
| 01000001   01000010   01000011   01000100   01000101   01000110   01000111    |
|                                                                               |
| H:         I:         J:         K:         L:         M:         N:          |
| 01001000   01001001   01001010   01001011   01001100   01001101   01001110    |
|                                                                               |
| O:         P:         Q:         R:         S:         T:         U:          |
| 01001111   01010000   01010001   01011010   01010011   01010100   01010101    |
|                                                                               |
| V:         W:         X:         Y:         Z:                                |
| 01010110   01010111   01011000   01011001   01011010                          |
|-------------------------------------------------------------------------------|
| Braille:                                                                      |
|                                                                               |
| A:    B:    C:    D:    E:    F:    G:    H:    I:    J:    K:    L:    M:    |
| .     .     . .   . .   .     . .   . .   .       .     .   .     .     . .   |
|       .             .     .   .     . .   . .   .     . .         .           |
|                                                             .     .     .     |
|                                                                               |
| N:    O:    P:    Q:    R:    S:    T:    U:    V:    W:    X:    Y:    Z:    |
| . .   .     . .   . .   .       .     .   .     .       .   . .   . .   .     |
|   .     .   .     . .   . .   .     . .         .     . .           .     .   |
| .     .     .     .     .     .     .     . .   . .     .   . .   . .   . .   |
|-------------------------------------------------------------------------------|
| Keyboard:                                                                     |
|                                                                               |
| A:    B:    C:    D:    E:    F:    G:    H:    I:    J:    K:    L:    M:    |
| Q     W     E     R     T     Y     U     I     O     P     A     S     D     |
|                                                                               |
| N:    O:    P:    Q:    R:    S:    T:    U:    V:    W:    X:    Y:    Z:    |
| F     G     H     J     K     L     Z     X     C     V     B     N     M     |
|-------------------------------------------------------------------------------|
| Morse:                                                                        |
|                                                                               |
| A:    B:    C:    D:    E:    F:    G:    H:    I:    J:    K:    L:    M:    |
| .-   -...  -.-.   -..    .   ..-.   --.  ....   ..   .---   -.-   .-..  --    |
|                                                                               |
| N:    O:    P:    Q:    R:    S:    T:    U:    V:    W:    X:    Y:    Z:    |
| -.    ---  .--.  --.-   .-.   ...    -    ..-  ...-   .--  -..-  -.--  --..   |
|_______________________________________________________________________________|
