-----------------------------------------------------------------------------------------------
                             __________             __________
                            |  __  __  |           |  __  __  |
                            | |  ||  | |           | |  ||  | |
                            | |  ||  | |           | |  ||  | |
                            | |__||__| |           | |__||__| |
                            |  __  __()|           |  __  __()|
                            | |  ||  | |           | |  ||  | |
                            | |  ||  | |           | |  ||  | |
                            | |  ||  | |           | |  ||  | |
                            | |  ||  | |           | |  ||  | |
                            | |__||__| |           | |__||__| |                                                        
                            |__________|           |__________|

-----------------------------------------------------------------------------------------------
